10
6
1 1 1 0 0 0 0 1 1 1
1 1 1 1 0 0 1 1 1 1
1 0 0 0 1 1 0 0 0 1
1 1 1 1 1 1 1 1 1 1
0 1 1 0 0 0 0 1 1 0
0 1 1 0 0 0 0 1 1 0

level 1
1s are blocks
0s are empty space